00000000000000000000000000
00000000000000000000000000
00111111001111110011111100
00111111001111110011111100
00111111001111110011111100
00111111001111110011111100
00111111001111110011111100
00111111001111110011111100
00000000000000000000000000
00000000000000000000000000
00111111001111110011111100
00111111001111110011111100
00111111001111110011111100
00111111001111110011111100
00111111001111110011111100
00111111001111110011111100
00000000000000000000000000
00000000000000000000000000
00111111001111111111111100
00111111001111111111111100
00111111001111111111111100
00111111001111111111111100
00111111001111111111111100
00111111001111111111111100
00000000000000000000000000
00000000000000000000000000 